allee|a|al
autobahn
bach
bad
bahnhof|bhf|bf
boulevard|bd
brücke|br|brucke|bruecke
buhl|buehl
chaussee|ch
damm|d
forsthaus|fh
gasse|g
graben|gr
großser|grosser
große|grosse|gr|g
großes|grosses
heiligen
hof|h
kamp|k
obere|ob
oberer|ob
oberes
pfad
platz|pl
quelle|qu
rundwanderweg|rww
steg
straße|str|strasse
ufer
untere|u
unterer
unteres
weg|w