awang|awg
bulatan
changkat|ckt
cerunan|crn
dalaman|dlm
dataran|dtr
dayang|dyg
denai
gerbang|grb
haji|hj
halaman|hlm
hilir|hlr
jalan|jln|jl
lapangan
laluan
laman|lmn
langgak|lgk
lebuh|lbh|luh
lebuhraya|lbr
lengkok|lkk
linkaran|lkr
lintang|ltg
lorong|lrg
kampong|kampung|kg
medan|mdn
pengiran|pg
persiaran|psn|psrn
rapat
simpang|spg
simpangan|spn
sisiran|ssr
solok|slk
sungai|sngai|sg
tingkat|tkt
taman|tmn
tepian|tpn
